000000000
010010010
010010010
021121110
010000010
010000010
010000010
021111120
000000000