000000000000
021111120000
010000010000
010000010000
010000010000
010000021120
010000000010
010000021120
021111120000
000000000000