00000000000
02111111120
01000000010
01000000010
01000000010
01000000010
02111111120
00000000000