0000000000
0000010000
0000010000
0111121110
0111121110
0000010000
0000010000