0000000000000
0100100100100
0110100100100
0011211200100
0000100100100
0000200200100
0000100100100
0000000000000